111111111111
1  222222121
1  222222121
111112222221
122222222221
122111112221
122122212221
122222212211
122222212221
122112212221
122222222221
111111111111
